Portland Timbers 2	Seattle Sounders FC 2
Toronto FC II	New York Red Bulls II
Nashville SC	Louisville City FC
North Carolina FC	Tampa Bay Rowdies
Charleston Battery	FC Cincinnati
Ottawa Fury FC	Charlotte Independence
Reno 1868 FC	Swope Park Rangers
LA Galaxy II	Colorado Springs Switchbacks FC
Tulsa Roughnecks FC	Oklahoma City Energy FC
Fresno FC	Las Vegas Lights FC
San Antonio FC	Sacramento Republic FC
Richmond Kickers	Bethlehem Steel FC
New York Red Bulls II	Atlanta United 2
Penn FC	Charleston Battery
Bethlehem Steel FC	Tampa Bay Rowdies
Colorado Springs Switchbacks FC	Portland Timbers 2
Saint Louis FC	San Antonio FC
Seattle Sounders FC 2	Swope Park Rangers
Orange County SC	Sacramento Republic FC
Oklahoma City Energy FC	Phoenix Rising FC
Charleston Battery	New York Red Bulls II
Tampa Bay Rowdies	Louisville City FC
Portland Timbers 2	Real Monarchs
Indy Eleven	FC Cincinnati
Swope Park Rangers	Las Vegas Lights FC
FC Cincinnati	Louisville City FC
Rio Grande Valley FC Toros	Colorado Springs Switchbacks FC
Charlotte Independence	Nashville SC
Phoenix Rising FC	Real Monarchs
Nashville SC	Indy Eleven
San Antonio FC	Orange County SC
Colorado Springs Switchbacks FC	Sacramento Republic FC
Real Monarchs	Tampa Bay Rowdies
Atlanta United 2	Charleston Battery
Orange County SC	Rio Grande Valley FC Toros
Las Vegas Lights FC	San Antonio FC
Tampa Bay Rowdies	Charleston Battery
